"filename", "language", "Python", "Markdown", "JSON", "HTML", "JavaScript", "comment", "blank", "total"
"d:\code\twitterAuto\core\TFA.py", "Python", 4, 0, 0, 0, 0, 0, 1, 5
"d:\code\twitterAuto\core\Timer.py", "Python", 45, 0, 0, 0, 0, 8, 6, 59
"d:\code\twitterAuto\core\autoScript\test_twitterAuto.py", "Python", 32, 0, 0, 0, 0, 0, 2, 34
"d:\code\twitterAuto\core\autoScript\twitterAuto.py", "Python", 67, 0, 0, 0, 0, 13, 15, 95
"d:\code\twitterAuto\core\database\Task.py", "Python", 13, 0, 0, 0, 0, 7, 17, 37
"d:\code\twitterAuto\core\database\User.py", "Python", 16, 0, 0, 0, 0, 1, 3, 20
"d:\code\twitterAuto\core\error.py", "Python", 0, 0, 0, 0, 0, 0, 1, 1
"d:\code\twitterAuto\core\test\TestTimer.py", "Python", 10, 0, 0, 0, 0, 0, 3, 13
"d:\code\twitterAuto\core\test\UserTest.py", "Python", 24, 0, 0, 0, 0, 0, 6, 30
"d:\code\twitterAuto\core\window\main_window.py", "Python", 118, 0, 0, 0, 0, 17, 13, 148
"d:\code\twitterAuto\main.py", "Python", 15, 0, 0, 0, 0, 7, 6, 28
"d:\code\twitterAuto\readme.md", "Markdown", 0, 6, 0, 0, 0, 0, 3, 9
"d:\code\twitterAuto\templates\index.html", "HTML", 0, 0, 0, 328, 0, 0, 41, 369
"d:\code\twitterAuto\templates\vue.global.js", "JavaScript", 0, 0, 0, 0, 17577, 389, 131, 18097
"d:\code\twitterAuto\testUserData.json", "JSON", 0, 0, 32, 0, 0, 0, 1, 33
"d:\code\twitterAuto\testUserData_1.json", "JSON", 0, 0, 9, 0, 0, 0, 0, 9
"Total", "-", 344, 6, 41, 328, 17577, 442, 249, 18987